00000###0##########00000000###
####00000000000000########0###
####0############0000000##0###
####0#0#####0####0########0###
#0000#000000000000000#####0###
####0####0##########0000000###
####0####0##########0#####0000
####0####00000000#########0###
####0#######0#####0000000#0###
X000000000##0#####0#####000###
######0####000##00000#######0G
##0###0####0#0######0###00000#
##0###0####0#0######0###0#####
##0###0####0#0######0###0#####
##0###0####0#0######0###000000
##0000000000#000000000000#####
####0#########################
